NO ./ASSETS/Black_Brick_512.xpm
SO ./ASSETS/Black_Brick_512.xpm
WE ./ASSETS/Black_Brick_512.xpm
EA ./ASSETS/Black_Brick_512.xpm

CE ./ASSETS/Waffle_256.xpm
FL ./ASSETS/Dirty_Vinyl_256.xpm


111111111111111111111111111111111111111111111111111111111111111111111111111111111
11100000000Z000011100000000000000000000001000000ZZ0000000000000000000000001111111
11100000000000000D01000000000001000000000D000000000000ZZ0000000000000000001111111
111000011111111111100000000000000000000001000000Z000ZZ000000000000000000001111111
111000011111111111111111111111111111111101111111111111111111111111111111111111111
111000000000000000000000001111111111111101111111111111111111111111111111111111111
111000Z000000000000000000011111111111111Z1111111111111111111111111111111111111111
11111111111111111111000Z001111111111111101111111111111111111111111111111111111111
1111111111111111111100000011111111111111D1111111111111111111111111111111111111111
11111111111111111111000Z000000DZD0011111ZD011111111111111111111111111111111111111
1111111111111111111100000000111110011100Z1011111111000000000001111111111111111111
111111111111111111111011111111111001111001111000000000000000000000000000111111111
111111111111111111111D11111111111001111001111111111111011111111111111110111111111
111111111111111111110000000000D00Z0111110D011111111111D11111111111111110111111111
1111111111111111111100000000111100011100Z1011000111000000000001111111110111111111
111111111111111111111111111111111001111001111000000000000Z00000000000000111111111
111111111111111111111111111111111D11111011111111111111111111111111111111111111111
111111111111111111111111111111111001100000011001111111111111111111111111111111111
111111111111111111111111111111111000100001011001111111111111111111111111111111111
11111111111111111111111111111111101D100000000001111111111111111111111111111111111
111111111111111111111111111111111000000000000001111111111111111111111111111111111
111111111111111111111111111111111D1D1D1000000001111111111111111111111111111111111
1111111111111111111111111111111110000000N0000011111111111111111111111111111111111
111111111111111111111111111111111000000000000001111111111111111111111111111111111
111111111111111111111111111111111111111111111111111111111111111111111111111111111
111111111111111111111111111111111111111111111111111111111111111111111111111111111
111111111111111111111111111111111111111111111111111111111111111111111111111111111
